198,670,975,870,754,327,497,851
384,900,310,262,546,652,919,247
137,701,826,162,562,323,515,15
840,984,148,792,554,776,569,521
364,558,957,176,966,241,284,552
19,597,201,897,121,563,680,431
962,899,986,317,594,715,43,702
343,767,78,65,254,159,994,990